BBBBBBBBBBBBBBBBBBBBBBBB
B..............E.......B
B......................B
B......F...............B
B......B......F........B
B.............BB.......B
B........BB............B
B..........BBBBB.......B
B................H.....B
BBBBBBBBBBBBBBBBBBBBBBBB