BBBBBBBBBBBBBBBBBBBBBBBB
B.......C......E.......B
B..S.........S.........B
B..........C.....E.C...B
BS.....B...........B...B
B..C..........BB...B...B
B........BB......S.B...B
B..........BBBBB.......B
B................H.....B
B...BBBBBBBBBBBBBBBBBBBB
B..........C...........B
B.......BB........S....B
B...C....BBB...........B
B...............C......B
BBBBBBBBBBBBBBBBBBBBBBBB
