BBBBBBBBBBBBBBBBBBBBBBBB
B......................B
B......................B
B......................B
BS.....................B
B......................B
B......................B
B......................B
B......................B
B......................B
B......................B
B......................B
B......................B
B......................B
BBBBBBBBBBBBBBBBBBBBBBBB