BBBBBBBBBBBBBBBBBBBBBBBB
B..S...........E.......B
B......................B
B......T...............B
B......B......T........B
B.............BB.......B
B........BB..........S.B
B..........BBBBB.......B
B...S............H.....B
BBBBBBBBBBBBBBBBBBBBBBBB