BBBBBBBBBBBBBBBBBBBBBBBB
B..S...........E.......B
B............S.........B
B......................B
BS.....B...............B
B.............BB.......B
B........BB..........S.B
B..........BBBBB.......B
B...S............H.....B
BBBBBBBBBBBBBBBBBBBBBBBB