BBBBBBBBBBBBBBBBBBBBBBBB
B.......C......E.......B
B............S.........B
B....S.....C.......C...B
BS.....B...............B
B..C....S.....BB.......B
B........BB......S.....B
B..........BBBBB.......B
B................H.....B
B...BBBBBBBBBBBBBBBBBBBB
B......................B
B.......BB.............B
B........BBB...........B
B......................B
B......................B
BBBBBBBBBBBBBBBBBBBBBBBB